###########################################
#.........................................#
#.........................................#
#.........................................#
#.........................................#
#.........................................#
#.........................................#
#.........................................#
#.........................................#
#.........................................#
#.........................................#
#.........................................#
#.........................................#
#.........................................#
#.........................................#
#.........................................#
#.........................................#
#.........................................#
#.........................................#
#.........................................#
#.........................................#
#.........................................#
#.........................................#
#.........................................#
#.........................................#
#.........................................#
#.........................................#
#.........................................#
#.........................................#
#.........................................#
#.........................................#
#.........................................#
#.........................................#
#.........................................#
#.........................................#
#.........................................#
#.........................................#
#.........................................#
#.........................................#
#.........................................#
#.........................................#
#.........................................#
#.........................................#
#.........................................#
#.........................................#
#.........................................#
#.........................................#
#.........................................#
#.........................................#
#.........................................#
#.........................................#
#.........................................#
#.........................................#
#.........................................#
#.........................................#
#.........................................#
#.........................................#
#.........................................#
#.........................................#
#.........................................#
#.........................................#
#.........................................#
#.........................................#
#.........................................#
#.........................................#
#.........................................#
#.........................................#
#.........................................#
#.........................................#
#.........................................#
#.........................................#
#.........................................#
#.........................................#
#.........................................#
#.........................................#
#.........................................#
#.........................................#
#.........................................#
#.........................................#
#.........................................#
#.........................................#
#.........................................#
#.........................................#
#.........................................#
#.........................................#
#.........................................#
#.........................................#
#.........................................#
#.........................................#
#.........................................#
#.........................................#
#.........................................#
#.........................................#
#.........................................#
#.........................................#
#.........########........................#
########..................................#
#.........................................#
#.........................................#
###########################################
