#...........................................................................................................................................................#
#...........................................................................................................................................................#
#..............................S....s.......................................................................................................................#
#..............................^....^............................................s..........................................................................#
#..................%444446.....^....^.......................................................................................................................#
#.................!.........xxx^..f.^.f.##...c.....xx....f..f...f...f..f.....................f.....f..hmh.f...f.........................f...f....f....f..Sgs#
#Ssxxxx.....c...!!gS...##################..#####..###############################..##################################.....s...###############################
#44444446..7$$$$111...........................#xx..................................................................####.....###.............................#
#..#................##.........xx..............#####.....................................................................###................................#
#fS#..mh......................####.............S....#..............................................................................................sxxxxxx..#
##....##..............xx..xxx.................hgm...####........................................................###########################################.#
#....................###..###......##....##..####........xx................................................xx...#.........................................#.#
#...............g.......................................####.....................S........................####............................................#.#
#........##....##...........................................#.xx.....................................xxx.#................................................#.#
#............................................................#####.................................######.................@...............................#.#
#..........##.....##..............................g...............#.xx........................xxx.................gS..s..@..@@..m.........................#.#
#.#....................xsSx.......................#................#####.....................#####..........S.....@@..@........@@@........................#.#
#.....................#####...##.##.....................................#..............xxxx.................@@.....................@@.@.@.@..@@.@@........#.#
#...#..........................................s.........................###...........#####........................................................#.....#.#
#.....""""........................##..#####...###...........................#...xfxxx...............................................................##....#.#
#xhx..#......................##......c.........................................########.............................................................###...#.#
#"""""#.....#........................#..................................#######.....................................................................####....#
##..........#...................hmh...................................##............................................................................#####...#
##xhgmx..#####..fxxxxsxxxxx"..."""""..................................................c...f...f...f..f..f..f...f.hc.f...f..f..f....f...f..f...hc....######..#
######"""####################################################################################################################################################
